0	0	0	0	0	0	0	0	0	0	0	0	0	0	0	0	0	0	0	0
0	0	0	0	0	0	0	0	0	0	0	0	0	0	0	0	0	0	0	0
0	0	0	0	0	0	0	0	0	0	0	0	0	0	0	0	0	0	0	0
0	0	0	0	0	0	0	0	0	0	0	0	0	0	0	0	0	0	0	0
0	0	0	0	0	0	0	0	0	0	0	0	0	0	0	0	0	0	0	0
0	0	0	0	0	0	0	0	0	0	0	0	0	0	0	0	0	0	0	0
0	0	0	0	0	0	0	0	0	0	0	0	0	0	0	0	0	0	0	0
0	0	0	0	5	3	0	5	3	0	5	3	0	5	3	0	5	3	0	0
3	0	5	1	2	4	0	6	4	0	6	4	0	6	4	0	6	4	0	5
4	0	6	2	2	4	0	6	4	0	6	4	0	6	4	0	6	4	0	6
0	0	0	0	0	0	0	0	0	0	0	0	0	0	0	0	0	0	0	0

