0	0	0	0	0	0	0	0	0	0	0	0	0	0	0	0	0	0	0	0
0	0	0	0	0	0	0	0	0	0	0	0	0	0	0	0	0	0	0	0
0	0	0	0	0	0	0	0	0	0	0	0	0	0	0	0	0	0	0	0
0	0	0	0	0	0	0	0	0	0	0	0	0	0	0	0	0	0	0	0
0	0	0	0	0	0	0	0	0	0	0	0	0	0	0	0	0	0	0	0
0	0	0	0	0	0	0	0	0	0	0	0	0	0	0	0	0	0	0	0
0	0	0	5	1	3	0	0	5	1	3	0	0	0	0	0	0	0	0	0
0	5	1	2	2	4	0	0	6	2	4	0	0	5	1	3	0	0	7	0
1	2	2	2	2	4	0	0	6	2	4	0	0	6	2	4	0	0	6	1
2	2	2	2	2	4	0	0	6	2	4	0	0	6	2	4	0	0	6	2
0	0	0	0	0	0	0	0	0	0	0	0	0	0	0	0	0	0	0	0

