0	0	0	0	0	0	0	0	0	0	0	0	0	0	0	0	0	0	0	0
0	0	0	0	0	0	0	0	0	0	0	0	0	0	0	0	0	0	0	0
0	0	0	0	0	0	0	0	0	0	0	0	0	0	0	0	0	0	0	0
0	0	0	0	0	0	0	0	0	0	0	0	0	0	0	0	0	0	0	0
0	0	0	0	0	0	0	0	0	0	0	0	0	0	0	0	0	0	0	0
0	0	0	0	0	0	0	0	0	0	0	0	0	0	0	0	0	0	0	0
0	0	0	0	0	0	0	0	0	0	0	0	0	0	0	0	0	0	0	0
0	0	0	0	7	0	5	1	3	0	0	0	0	0	0	0	0	0	0	0
1	1	3	0	8	0	6	2	4	0	5	3	0	0	7	0	0	7	0	5
2	2	4	0	8	0	6	2	4	0	6	4	0	0	8	0	0	8	0	6
0	0	0	0	0	0	0	0	0	0	0	0	0	0	0	0	0	0	0	0

