0	0	0	0	0	0	0	0	0	0	0	0	0	0	0	0	0	0	0	0
0	0	0	0	0	0	0	0	0	0	0	0	0	0	0	0	0	0	0	0
0	0	0	0	0	0	0	0	0	0	0	0	0	0	0	0	0	0	0	0
0	0	0	0	0	0	0	0	0	0	0	0	0	0	0	0	0	0	0	0
0	0	0	0	0	0	0	0	0	0	0	0	0	0	0	0	0	0	0	0
0	0	0	0	0	0	0	0	0	0	0	0	0	0	0	0	0	0	0	0
0	0	0	0	7	0	7	0	7	0	7	0	7	0	0	0	0	0	0	0
0	0	7	0	8	0	8	0	8	0	8	0	8	0	7	0	7	0	0	0
3	0	8	0	8	0	8	0	8	0	8	0	8	0	8	0	8	0	5	1
4	0	8	0	8	0	8	0	8	0	8	0	8	0	8	0	8	0	6	2
0	0	0	0	0	0	0	0	0	0	0	0	0	0	0	0	0	0	0	0

