0	0	0	0	0	0	0	0	0	0	0	0	0	0	0	0	0	0	0	0
0	0	0	0	0	0	0	0	0	0	0	0	0	0	0	0	0	0	0	0
0	0	0	0	0	0	0	0	0	0	0	0	0	0	0	0	0	0	0	0
0	0	0	0	0	0	0	0	0	0	0	0	0	0	0	0	0	0	0	0
0	0	0	0	0	0	0	0	0	0	0	0	0	0	0	0	0	0	0	0
0	0	0	0	0	0	0	0	0	0	0	0	0	0	5	3	0	0	0	0
0	0	0	0	0	0	0	0	0	0	0	5	3	0	6	4	0	0	0	0
0	0	5	3	0	0	0	0	5	3	0	6	4	0	6	4	0	0	0	0
3	0	6	4	0	5	3	0	6	4	0	6	4	0	6	4	0	0	5	1
4	0	6	4	0	6	4	0	6	4	0	6	4	0	6	4	0	0	6	2
0	0	0	0	0	0	0	0	0	0	0	0	0	0	0	0	0	0	0	0
