0	0	0	0	0	0	0	0	0	0	0	0	0	0	0	0	0	0	0	0
0	0	0	0	0	0	0	0	0	0	0	0	0	0	0	0	0	0	0	0
0	0	0	0	0	0	0	0	0	0	0	0	0	0	0	0	0	0	0	0
0	0	0	0	0	0	0	0	0	0	0	0	0	0	0	0	0	0	0	0
0	0	0	0	0	0	0	0	0	0	0	0	0	0	0	0	0	0	0	0
0	0	0	0	0	0	0	0	0	0	0	0	0	0	0	0	0	0	0	0
0	0	0	0	0	0	0	0	0	0	0	0	0	0	0	0	0	7	0	0
0	0	5	3	0	0	0	0	0	0	0	0	0	0	0	7	0	8	0	0
3	0	6	4	0	0	0	0	0	0	0	0	0	7	0	8	0	8	0	5
4	0	6	4	0	0	5	3	0	0	5	3	0	8	0	8	0	8	0	6
0	0	0	0	0	0	0	0	0	0	0	0	0	0	0	0	0	0	0	0

